1111111111111111111111111111111111
11000000000000C00000C0000000000011
11000000000000C00000C0000000000011
11000000000000C00000C0000000000011
11000000000000C00000C0000000000011
11000000000000100000C0000000000011
P0000100C01C1000E00000000000000C1
1111111111111111111111111111111111