SO ./path_to_the_south_texture
NO ./path_to_the_north_texture   
WE ./path_to_the_west_texture
EA ./path_to_the_east_texture 
C 225,30,0
F 1,1,1
111
111
111
11111111111111111111111111
11111111111111111111111111
11111111111111111111111111
11111111111111111111111111
11111111111111111111111111
11111111111111111111111111
11111111111111111111111111
11111111111111111111111111
11111111111111111111111111
11111111111111111111111111
11111111111111111111111111
11111111111111111111111111
111111111111111111111111111      11
1111111111111111111111111111111111
1111111111111111111111111111
11111111111111111111111111
11111111111111111111111111
11111111111111111111111111
11111111111111111111111111
11111111111111111111111111
11111111111111111111111111
11111111111111111111111111
11111111111111111111111111
11111111111111111111111111
11111111111111111111111111
11111111111111111111111111
1111111111111111111111111N1
