SO ./path_to_the_south_texture
NO ./path_to_the_north_texture   
WE f
EA ./path_to_the_east_texture     
C 1,8,3
F 1,1,100
111
111
111
 11111111111111111111111111
11111111111111111111111111
11111111111111111111111111
11111111111111111111111111
11111111111111111111111111
11111111111111111111111111
11111111111111111111111111
11111111111111111111111111
11111111111111111111111111
11111111111111111111111111
11111111111111111111111111
11111111111111111111111111
111111111111111111111111111    11
111111111111111111111111111111111
1111111111111111111111111111101111
1111111111111111111111111111111101
1111111111111N111111111111111111111
11111111111111111111111111
11111111111111111111111111
11111111111111111111111111
11111111111111111111111111
1111111111111111111111111
11111111111111111111111111
11111111111111111111111111
11111111111111111111111111
11111111111111111111111111
111111111111111111111111111
